40:675
41:676
42:677
43:720
44:721
45:722
46:765
47:766
48:767
----
0770,00 0770,00 0770,00 0770,00 0770,00 0770,00 0770,00 0770,00 0770,00 0770,00 0770,00 0770,00 0770,00 0770,00 0770,00 0770,00 0770,00 0770,00 0770,00 0770,00
0770,00 0770,00 0770,00 0770,00 0770,00 0770,00 0770,00 0770,00 0770,00 0770,00 0770,00 0770,00 0770,00 0770,00 0770,00 0770,00 0770,00 0770,00 0770,00 0770,00
0770,00 0770,00 0770,00 0770,00 0770,00 0770,00 0770,00 0770,00 0770,00 0770,00 0770,00 0770,00 0770,00 0770,00 0770,00 0770,00 0770,00 0770,00 0770,00 0770,00
0770,00 0770,00 0770,40 0770,41 0770,42 0770,00 0770,00 0770,00 0770,00 0770,00 0770,00 0770,00 0770,00 0770,00 0770,00 0770,00 0770,00 0770,00 0770,00 0770,00
0770,00 0770,00 0770,43 0770,44 0770,45 0770,00 0770,00 0770,00 0770,00 0770,00 0770,00 0770,00 0770,00 0770,00 0770,00 0770,00 0770,00 0770,00 0770,00 0770,00
0770,00 0770,00 0770,46 0770,47 0770,48 0770,00 0770,00 0770,00 0770,00 0770,00 0770,00 0770,00 0770,00 0770,00 0770,00 0770,00 0770,00 0770,00 0770,00 0770,00
0770,00 0770,00 0770,00 0770,00 0770,00 0770,00 0770,00 0770,00 0770,00 0770,00 0770,00 0770,00 0770,00 0770,00 0770,00 0770,00 0770,00 0770,00 0770,00 0770,00
0770,00 0770,00 0770,00 0770,00 0770,00 0770,00 0770,00 0770,00 0770,00 0770,00 0770,00 0770,00 0770,00 0770,00 0770,00 0770,00 0770,00 0770,00 0770,00 0770,00
0770,00 0770,00 0770,00 0770,00 0770,00 0770,00 0770,00 0770,00 0770,00 0770,00 0770,00 0770,00 0770,00 0770,00 0770,00 0770,00 0770,00 0770,00 0770,00 0770,00
0770,00 0770,00 0770,00 0770,00 0770,00 0770,00 0770,00 0770,00 0770,00 0770,00 0770,00 0770,00 0726,00 0727,00 0770,00 0770,00 0770,00 0770,00 0770,00 0770,00
0770,00 0770,00 0770,00 0770,00 0770,00 0770,00 0770,00 0770,00 0770,00 0770,00 0770,00 0770,00 0680,00 0680,00 0770,00 0770,00 0770,00 0770,00 0770,00 0770,00
0770,00 0770,00 0770,00 0770,00 0770,00 0770,00 0770,00 0770,00 0770,00 0770,00 0770,00 0770,00 0771,00 0772,00 0770,00 0770,00 0770,00 0770,00 0770,00 0770,00
0770,00 0770,00 0770,00 0770,00 0770,00 0770,00 0770,00 0770,00 0770,00 0770,00 0770,00 0770,00 0770,00 0770,00 0770,00 0770,00 0770,00 0770,00 0770,00 0770,00
0770,00 0770,00 0770,00 0770,00 0770,00 0770,00 0770,00 0770,00 0770,00 0770,00 0770,00 0770,00 0770,00 0770,00 0770,00 0770,00 0770,00 0770,00 0770,00 0770,00
0770,00 0770,00 0770,00 0770,00 0770,00 0770,00 0770,00 0770,00 0770,00 0770,00 0770,00 0770,00 0770,00 0770,00 0770,00 0770,00 0770,00 0770,00 0770,00 0770,00